##########
#S..#....#
#.#.#.##.#
#.#...#..#
#.###.#E.#
#........#
##########
